000000000000000000000
000001011111111110100
111101010010010011100
010101011111110010100
010101010000000010100
010101010000111110100
010111110000100000100
000001000000100000000
000001001111111111111
000000000000000000000
